X------------------X-------XXXXX---X-X-X-X---XXXXXXXXX-----------WX
X-----X------------X---------------X-X-X-X------------------ZZ--XXX
X-P--XXX--------------------M-M----------------M-M-M----SS--XX-----
X---XXXXX--M----S--X--Z---XXXXXXX--S-Z-S-Z---XXXXXXXXX--XX---------
XXXXXXXXXXXXXX--XX-X-XX--XXXXXXXXX-X-X-X-X--XXXXXXXXXXX------------
-------------------------------------------------------------------
-------------------------------------------------------------------
BBBBBBBBBBBBBBBBBBBBBBBBBBBBBBBBBBBBBBBBBBBBBBBBBBBBBBBBBBBBBBBBBBB
-------------------------------------------------------------------
-------------------------------------------------------------------