X------------------X-------XXXXX---X-X-X-X-----
X-----X------------X---------------X-X-X-X-----
X-P--XXX---------------------M-----------------
X---XXXXX--M----S--X--Z----XXXXX---S-Z-S-Z-----
XXXXXXXXXXXXXX--XX-X-XX--XXXXXXXXX-X-X-X-X-XXXX
-----------------------------------------------
-----------------------------------------------
BBBBBBBBBBBBBBBBBBBBBBBBBBBBBBBBBBBBBBBBBBBBBBB
-----------------------------------------------
-----------------------------------------------