X-----------------X--------------X
X-----X-----------X--------------X
X-P-WXXX-------------------------X
X---XXXXX--M---S--X--Z-----XXX---X
XXXXXXXXXXXXX--XX-X-XX--XXXXXXXXXX
----------------------------------
----------------------------------
----------------------------------
SSSSSSSSSSSSSSSSSSSSSSSSSSSSSSSSSS
XXXXXXXXXXXXXXXXXXXXXXXXXXXXXXXXXX