X-----------------X--------------X
X-----X-----------X--------------X
X-P--XXX-------------------------X
X---XXXXX--M---S--X--Z-----XXX---X
XXXXXXXXXXXXX--XX-X-XX--XXXXXXXXXX